mulatto = blandning av svart/vit ras
aver = bestämt förklara
mestizo = blandning av europé och indian
elicit = locka fram
imposture = bedrägeri
charlatanry = kvacksalveri
rebuke = skarpt tillrättavisa
stucco = dekorativ puts
steeple = tornspira
concede = medge
decadent = dekadent
frail = skör
unkempt = ovårdad
aspect = utseende
languid = likgiltig/svag
residuum = drägg
catechism = förhör
amiable = vänlig
inexplicable = oförklarlig
mongrel = byracka/bastard
avid = glupsk
portentous = olycksbådande/vidunderlig
derelict = övergiven
perfunctory = oengagerad/vårdslös
baleful = ondskefull
palpitant = kraftigt slående (hjärta)
constitution = kondition
impios = gudlös
miasma = dimma/giftig gas
leer = snegla/lömsk blick
lintel = överläggare
jamb = dörrpost
interminable = ändlöst
slobber = dregla
flounder = plumsa