of yore = forntida
mawkish = överdrivet sentimental; mjäkig
allegory = bild/text med dold innebörd
palliative = lindrande
erudition = lärdom
shrewd = klipsk
arabesque = dekorativt mönster
rustic = lantlig
vale = dal
verdant = grönskande
dank = fuktig
croon = nynna
knoll = kulle
bough = stor trädgren
runic = run-
artifice = påhitt
reproof = förebråelse
turret = litet torn 
amorphous = formlös
blight = fördärv
entreat = bönfalla
flit = fladdra
piquant = något som retar sinnena (positivt)
beguile = tjusa; fördriva tiden
flutter = fladdra
gourd = [kärl av] tropisk gurkväxt
boreal = nordlig
amicable = vänlig
festoon = girlang
guile = list; svek
hiccough = hicka
caterwaul = jama; väsnas
peal = dunder; klockringning
filigree = dekorativ snidning av guld/silver
basalt = basalt (grå bergart)
denizen = invånare