recalcitrant = motspänstig
phlegmatic = flegmatisk/långsam
exasperate = reta/förbittra
toil = slita
volition = vilja
indolent = slö
stout = tjock/modig
wholesale = i stor skala
ineffaceable = outplånlig
inextricable = ofrånkomlig
clangour = skrammel
brownstone = mörkbrun sandsten
sullied = befläckad (bildligt)
opulence = överflöd/välstånd
slatternly = slampig
trite = banal/sliten
pathos = lidelsefull känsla
seedy = krasslig
diurnal = daglig
sumptuous = praktfull/överdådlig
hanging = väggtapet/gobeläng
mellow = mogen/söt/fyllig
contiguous = angränsande
aquiline = örnlik
repugnance = avsky
deftness = jändighet
timbreless = saknar klangfärg
garrulous = pratsjuk
dingy = grådaskig
livid = dödsblek
resilence = spänstighet
caprice = nyck
sepulchre = grav
incessant = oavbrutet
lassitude = trötthet