forage = foder; söka efter foder
fray = strid; fransa sig
effusive = översvallande
asterism = grupp av stjärnor (mindre än stjärnbild)
transmontane = beläget på andra sidan bergen
remiss = försumlig
concernment = angelägenhet
fringe = periferi; frans
loin = länd
scorn = förakt
limn = beskriva i ord eller målning
sallow = gulblek
raucous = skrovlig; hes
grisly = gräslig
cohort = grupp individer
gait = gångstil
covetous = girig
roseal = rosaktig
recreant = feg; förrädare
legate = guvernör; kardinal
presumptous = övermodig
impetuous = impulsiv 
hurtle = stöta
stark = fullständig; stel; skarp
cackle = kackla
populous = folkrik
jostle = knuffa
kalpa = lång tid
carmine = karminröd
trellis = spalje
arbour = berså
aberration = avvikelse; villfarelse
conjoin = förena
alienist = rättspsykiater
lucid = klar; strålande
expunge = utplåna