colloquial = vardaglig
malodorous = illaluktande
crotala = antika symbaler
dirge = sorgesång
bitumen = asfalt
undulant = böljande
unhallowed = gudlös
domdaniel = grotta på havets botten där onda magiker, andar och dvärgar möts
injunction = uppmaning
tenbrous = mörk
presage = förutsäga
vulturine = rovgirig
rickety = skröplig
swoon = svimma
gambrel roof = tak med två olika lutningar
wholesome = hälsosam
pervade = genomtränga
multitude = mängd/folkmassa
bucolic = idyllisk
bungle = misslyckas/fuska
lax = slapp
delver = grävare/forskare
lethargic = apatisk/slö
flimsy = bräcklig
ungainly = klumpig
flagrant = uppenbar
nonagenarian = nittioåring
thrifty = sparsam
vindictive = hämndlysten
tenacious = envis
compunction = skrupler
