titter = fnissa
anoint = smörja
gangrenous = drabbad av kallbrand/pest
arcade = rad av valvbågar
sardonic = hånfull
satyr = grekisk gud (faun)
succubae = kvinnlig demon, våldtar män
aegipan = gregisk gud (getman)
incubus = manlig demon, våldtar kvinnor
lemur = lemur (apa)
insidious = förrädisk
certitude = säkerhet
furtive = hemlig
poignant = bitter; skarp
teeming = myllrande
pinnacle = tornspira
wane = avta
firmament = himlavalv
redolent = luktar sött
dormer = vindsfönster
squalor = smutsighet
elephantiasis = oönskad stor tillväxt
garish = prålig
fragrance = söt doft
aught = något [alls]
ineffable = outsäglig
stridor = strävt, gällt eller knarrande ljud
sentient = känslig
stalwart = robust; trogen
ignoble = ovärdig; tarvlig