nibble = knapra på; nafsa efter
awning = markis
eidolon = ideal; spöke
charnal = kopplad till d�den
headland = udde
resplendent = skimmrande; glänsande
cataract = vattenfall; fors; grå starr
eldritch = spöklik; kuslig
tryst = avtalat möte (romantiskt)
whistle = vissla
caper = skutta
conjecture = gissa
leprous = spetälsk
van = skåpbil
hitch = haka fast
ignomonious = vanhedrande
lumbering = klumpig (rörelse)
lorry = lastbil
dray = flakvagn
quay = kaj
gambol = skutta
yowl = tjuta; jama
phalanx = falang
stupendous = häpnadsväckande
judicious = förståndig
desiderate = sakna
gaunt = mager
resin = koda
iridescent = regnsbågsskimrande
porpoise = tumlare
revel = frossa
monolith = stort föremål tillverkat ur en sten
porphyry = porfyr (röd bergart)
toothsome = läcker (om mat)
tether = tjudra
primal = grundläggande
blithe = munter