slaver = dregla
gibber = babbla
brine = saltvatten
cachinnate = gapskratta
audacity = djärvhet/fräckhet
reel = ragla/rulla
noisome = obehaglig
surmise = förmoda/gissa
chimaera = chimär (synvilla)/monster med lejonhuvud, getkropp och ormsvans
monograph = avhandling inom begränsat område
verily = sannerligen
parvenu = uppkomling (nyrik, exv.)
sanctimonious = skenhelig
puerile = barnslig
faugh = uttryck för avsky
palepink = rosa nyans
toboggan = kälke
antediluvian = väldigt gammal/före syndafloden
foetor = motbjudande lukt
gradation = gradering
settle = bosätta sig/träbänk med högt ryggstöd och armstöd
keel = köl/kantra
mephitic = illaluktande
ephemera = något med kortvarig betydelse
morsel = munsbit
grope = treva
leviathan = jättelik/sjöodjur
conch = trumpetsnäcka
laden = lastad
solemn = högtidlig
aether = eter
crag = skrovlig klippa
jaunty = käck/nonchalant
toll = tull/klockas slag