steed = springare (häst)
sable = svart; sobel (mårddjur)
dubious = tvivelaktig
balk = vägra
gouge = urholka
yawn = gäspa, gapa
scanty = otillräcklig; trång
brood = ruva
mitre = mitra
astride = grensle
rime = rimfrost
nitre = salpeter
hippocephalic = huvud format som hästhuvud
indubitable = otvivelaktig
dais = podium
incrustation = inkrustering; täckt med skorpa
lurid = spöklik; hemsk
snarl = morra
derisive = hånfull
twain = tu
primordial = ursprunglig
manfully = modigt; tappert
crusted = täckt med skorpa
pounce = plötslig rörelse
stifling = kvalmig
somnolent = sömnig
osseus = benmaterial
erstwhile = dåvarande
nonce = tillfälle
shirk = smita ifrån
plight = svår situation/tillstånd
anent = angeånde
precipitate = påskynda
lope = gå med långa kliv
font = dopfont; teckensnitt