primeval = ursprunglig
shingled = belagd med plattor
eave = takfot
romp = stoja; leka
soliloquy = monolog
colloquy = dialog
abode = hem
humdrum = enformig
estuary = flodmynning
beetle = skalbagge; rusa
brier = törnbuske
defile = besudla; trång passage
sidle = gå i sidled
casement = fönster med gångjärn
taciturn = tystlåten
sportive = lekfull
nereid = havsnymf
crenulated = ha ojämn outline
elfin = älvlik
boisterous = stormig
maritime = havs-; sjö-
coruscate = blixtra; gnistra
eyrie = rovfågels näste
vertiginous = svindlande; yr (i huvudet)
cotter = sprint; kil
inane = idiotisk; meningslös
dyspeptic = lider av dålig matsmältning
chalcedony = bergart (blå kristall)
fickle = ostadig
profess = bekänna (ofta oriktigt)
recourse = tillflykt
bondage = slaveri
sonorous = klangfull
ennui = ledsnad
bustle = jäkta
pall = göra övermätt
solace = tröst   