spectral = spöklik
rugged = skrovlig; kraftig
sombre = dyster; mörk
scoria = slagg
propitiate = blidka
anaemic = anemisk
friable = spröd
hew = hugga
loam = lera
slant = slutta; förstulen blick
giddy = yr
prehensile = gripande (fysiskt)
meep = gällt tjut
glib = munvig; talför
idiosyncrasy = idiosynkrasi; egenhet
capacious = rymlig
coterminous = sammanfallande
scabrous = oanständig; sträv
shamble = lufsa
redoubtable = fruktansvärd
sovereign = suverän
grouse = vild hönsfågel
quail = vaktel (fågel); tappa modet
pheasant = fasan
austere = sträng
dingle = liten skogig dal
jasper = jaspis (kvarts av godtycklig färg)
palanquin = orientalisk bärstol
fane = temple
lee = lä
sprightly = munter; pigg
lofty = hög; högfärdig
alabaster = alabaster (vit/brun bergart)
cedar = ceder (träslag)
calamander = calamonder (brunt trä med svarta ränder)