archaic = ålderdomlig
quaint = pittoresk; säregen
tinsel = prålig; falsk
venerable = vördnadsvärd
winding = snirklande
picturesque = pittoresk
endear = göra kör
tracery = spröjsverk; rosverk
transom = lågt fönster ovanför dörr eller bjälke
countenance = ansikte; tolerera
dreary = dyster
interstice = öppning; springa
efface = utplåna
totter = vackla
pilaster = väggpelare
fanlight = halvcirkelformat fönster
lozenge = romb
ponderous = tung
sconce = lampett
enjoin = ålägga
pediment = fronton
cornice = kranslist
overmantel = dekoration ovanför spiselkrans
enigmatic = gåtfull
tardily = långsamt
queued hair = hår samlat i en fläta
neck ruffles = prästkrage
knee-breeches = knäbyxor
hose = slang; hosor
rural = lantlig
sanctity = helighet
pestilent = dödsbringare; besvärlig