hum = sorl
rutted = spårig; upptrampad
feverish = febrig
vacuous = tom; meningslös
waft = föra (svävande) fram
tract = område
hobble = halta
stubbly = stubbig (sträv)
smock = arbetsrock
whisker = polisong/morrhår
pensive = fundersam
ramble = flanera
peep = kika
bower = lövsal; boning
cadence = tonfall
forecastle = främre del av skepp
wistful = längtansfull
loom = skymta
moor = hed; förtöja
bulbous = lökformig; svullen
fluting = räffla
taper = gradiv minska
belfry = klocktorn
slant = slutta; förstulen blick
squat = huka sig
jutting = utstickande
oriel = burspråk
colonnade = kollonad; rad av kolonner som bär tak
terminus = gränspost
buttress = strävpelare
parterr = blomsterparterr; plantering med stigar blommor och fontäner
espalier = spaljer
lattice = spjälverk
brazen = av mässing; fräck
tripod = stativ
tiller = jordbrukare
reticent = tystlåten
shaggy = lurvig