placid = fridfull
transient = övergående
dictum = utsago
bas-relief = skulpterad platta med lågt djup
vagary = nyck
pictorial = illustrerad
outré = ovanlig och skrämmande
allude = anspela
staid = stadgad; lugn
precocious = brådmogen
stilted = högtravande
verbatim = ordagrant
typify = exemplifiera
girdle = gördel; bälte
febrile = febril
prodigious = oerhörd; ofantlig
impertinent = oförskämd; påträngande
attainments = talanger; kunskapsnivå
convocation = församling; kallelse
erratic = oregelbunden
bloated = uppsvälld
corpulent = korpulent; kort och tjock
feeler = tentakel; trevare
striation = strimma
diffidence = blyghet
harrow = plåga; oroa
alight = stiga ur; brinnande
squawk = skrika gällt
orgiastic = orgiastisk
ululate = tjuta
bray = skria
scaffold = byggnadsställning
antiphonal = sång sjungen växelvis av två grupper
rout = vild flykt